Negative (subtraction less than 0)
Overflow ()
Carry
Zero (subtraction = 0)

cmp XX, YY = subs ZZ, XX, YY
cmp 5, 8

LT = N high
GT =
EQ = Z high
SO = V high


cmpwi = cmp = subs
cmplwi = subs but swap N w/ C?????


blo = logical blt = bcc =   C low
bhs = logical bge = bcs

ARM = PPC = Description
beq = beq = Z high
bne = bne = Z low
bgt = cmp/i+bgt = Z low && N == V
blt = cmp/i+blt = N =/= V
bge = N == V
ble = Z high || N =/=V
bhs = C high
blo = C low
bmi = N high
bpl = N low
bvs = V high
bvc = V low
bhi = Z low && C high
bls = Z high || C low
bcs = C high
bcc = C low
bal = Bits irrelevant







